BACK LEFT LEG MUSCLES
BLFE = BACK LEFT FEMUR EXTENSOR
BLFF = BACK LEFT FEMUR FLEXOR
BLME = BACK LEFT METATARSAL EXTENSOR
BLMF = BACK LEFT METATARSAL FLEXOR
BLTE = BACK LEFT TIBIA EXTENSOR
BLTF = BACK LEFT TIBIA FLEXOR

BACK RIGHT LEG MUSCLES
BRFE = BACK RIGHT FEMUR EXTENSOR
BRFF = BACK RIGHT FEMUR FLEXOR
BRME = BACK RIGHT METATARSAL EXTENSOR
BRMF = BACK RIGHT METATARSAL FLEXOR
BRTE = BACK RIGHT TIBIA EXTENSOR
BRTF = BACK RIGHT TIBIA FLEXOR

FRONT LEFT LEG MUSCLES
FLFE = FRONT LEFT FEMUR EXTENSOR
FLFF = FRONT LEFT FEMUR FLEXOR
FLME = FRONT LEFT METATARSAL EXTENSOR
FLMF = FRONT LEFT METATARSAL FLEXOR
FLTE = FRONT LEFT TIBIA EXTENSOR
FLTF = FRONT LEFT TIBIA FLEXOR

FRONT RIGHT LEG MUSCLES
FRFE = FRONT RIGHT FEMUR EXTENSOR
FRFF = FRONT RIGHT FEMUR FLEXOR
FRME = FRONT RIGHT METATARSAL EXTENSOR
FRMF = FRONT RIGHT METATARSAL FLEXOR
FRTE = FRONT RIGHT TIBIA EXTENSOR
FRTF = FRONT RIGHT TIBIA FLEXOR

OTHER CATEGORIES
FT = PNEUMATIC FITTINGS
MN = VALVE MANIFOLD
TU = PNEUMATIC TUBING

ASSORTED_FESTO_COMPONENTS = UNCATEGORIZED INTERNET DOWNLOADS

DEPRECATED = OUT-OF-DATE PARTS